Passionfruit - Drake
Slide (feat. Frank Ocean & Migos) - Calvin Harris
Peaches (feat. Daniel Caesar & Giveon) - Justin Bieber
love nwantiti (ah ah ah) - CKay
STUPID (feat. Yung Baby Tate) - Ashnikko
Cry Baby (feat. DaBaby) - Megan Thee Stallion
Cyber Sex - Doja Cat
Rules - Doja Cat
Still Don't Know My Name - Labrinth
Mount Everest - Labrinth
All For Us - from the HBO Original Series Euphoria - Labrinth
Wait a Minute! - WILLOW
Sweater Weather - The Neighbourhood
Washing Machine Heart - Mitski
Sunday Best - Surfaces
death bed (coffee for your head) - Powfu
Beef FloMix - Flo Milli
505 - Arctic Monkeys
Discord - The Living Tombstone
Infinity - Jaymes Young
Skechers - DripReport
WHATS POPPIN - Jack Harlow
Love Story - Taylor Swift
Deep End - Fousheé
Someone To You - BANNERS
FML - Arizona Zervas
Arcade - Duncan Laurence
Funny Thing - Thundercat
Backyard Boy - Claire Rosinkranz
M to the B - Millie B
Upside Down - JVKE
Lets Link - WhoHeem
Crank That (Soulja Boy) - Soulja Boy
Party Girl - StaySolidRocky
Blueberry Faygo - Lil Mosey
Break My Stride - Matthew Wilder
Whoopty - CJ
Lemonade - Internet Money
CITY OF ANGELS - 24kGoldn
Youngblood - 5 Seconds of Summer
Safe And Sound - Capital Cities
Waves - Robin Schulz Radio Edit - Mr. Probz
Unforgettable - French Montana
Ride It - Regard
HUMBLE. - Kendrick Lamar
Riptide - Vance Joy
Jackie Chan - Tiësto
Pompeii - Bastille
Hey, Soul Sister - Train
Mirrors - Justin Timberlake
SugarCrash! - ElyOtto
Leave The Door Open - Bruno Mars
Savage Love (Laxed - Siren Beat) - Jawsh 685
ROCKSTAR (feat. Roddy Ricch) - DaBaby
Falling - Trevor Daniel
It's Tricky - Run–D.M.C.
Lalala - Y2K
Snowman - Sia
Don't Rush (feat. Headie One) - Young T & Bugsey
What You Know Bout Love - Pop Smoke
Dancing in My Room - 347aidan
Stunnin' (feat. Harm Franklin) - Curtis Waters
Psycho! - MASN
Body (Remix) [feat. ArrDee, E1 (3x3), ZT (3x3), Bugzy Malone, Buni, Fivio Foreign & Darkoo] - Tion Wayne
Maneater - Nelly Furtado
Play Date - Melanie Martinez
Just the Two of Us - Grover Washington, Jr.
Careless Whisper - George Michael
Paparazzi - Lady Gaga
LoveGame - Lady Gaga
About Damn Time - Lizzo
Dark Red - Steve Lacy
Bad Habit - Steve Lacy
Pumped Up Kicks - Foster The People
Cool Kids - Sped Up - Echosmith
Long Way 2 Go - Cassie
Take My Breath Away - Love Theme from "Top Gun" - Berlin
Campus - Vampire Weekend
Build a Bitch - Bella Poarch
Castaways - The Backyardigans
edamame (feat. Rich Brian) - bbno$
Miss You - Oliver Tree
Players - Coi Leray
Kill Bill - SZA
Levitating (feat. DaBaby) - Dua Lipa
Boy's a Liar Pt. 2 - PinkPantheress
Munch (Feelin’ U) - Ice Spice
Cupid - Twin Ver. - FIFTY FIFTY
STAY (with Justin Bieber) - The Kid LAROI
Running Up That Hill (A Deal With God) - 2018 Remaster - Kate Bush
Heaven Knows I'm Miserable Now - 2011 Remaster - The Smiths
Love Me Again - John Newman
Meet Me At Our Spot - THE ANXIETY
Break My Stride - Matthew Wilder
Heat Waves - Glass Animals
Addison Rae - The Kid LAROI
STAY (with Justin Bieber) - The Kid LAROI
#doyalike - mikeeysmind
Knock Knock - SoFaygo
3 Vets - The Future Kingz